1111111
1000E01
1P000C1
1000001