1111111
1000E01
1P00AC1
1111111