1111111
1000E01
1PP00C1
1111111