1111111
1001E01
1P010C1
1111111