
1111111
1000E01
1P0A0C1
1111111